Chunk 1

###############################################################################                        
#       ^    ^        ^                            ___                        #                     
#      / \  / \ ^    / \             ~            /_|_\           ^      ^    #                       
#       ┴    ┴ / \    ┴             ~         ~    ║û║           / \    / \   #                   
#               ┴    _____|__      ^       ^ ~     ░░░       ~    ┴   ~  ┴    #                   
#    #####       ^    |    |      / \     / ▒               ~      ^ ~        #
#    #   #      / \   |  █ |     / █ \   / █ \             ~      / ▒         #
#    #####       ┴                                 ▓┼<    ▓        ┴          #
#                     >▓o          ^          ~        ~                ^     #
#     X                     ~     / \        ~  ~     ~         ~  O   / \    #
#            ^     ╔═══╝  ╚═~═╗  ~ ┴     ___▒_ ~     ░      ^ ~         ┴     # 
#           / \    ║▒▒▒▒▒▒▒~▓▒║  ▒~     |     ▒            / ▒                #
#            ┴     ║▒▒▒▒▒▒▓▒▒~║ / \     |  ▀  |\            ┴   ^       ^     #
#      ^           ║▒▒▒▒▒▒▒▒▓▒║  ┴      |_____|/               / \  ~  / \    #
#     / \          ║▒▒▒▒▒▒▒~~▒~~~~               ^     ^        ┴  ~ ~  ┴     #
#      ┴    ^      ║▒▒▒▒▒~▓▒▒▒~~~        ^      / \   / \          ▓~ ~       #
#          / \     ║▒▒▒▒▓▓~▒▒▒~~        / \      ┴     ┴          /▓▓ ~       #    
#           ┴    ^ ╚══════════╝          ┴         ^             ^ ┴          #     
#      ^        / \               ^         ^     / \       ^   / \      ^    #
#     / \        ┴       ^       / \       / \     ┴       / \   ┴      / \   #
#      ┴                / \       ┴         ┴               ┴            ┴    #
#                        ┴                                                    #
###############################################################################       

O is where the player has to move there in order to spawn into the next chunk.

Chunk 2

###############################################################################
#  ^            ^      ^  ^     ^                         ^         ^         #
# / \   ^      / \    / \/ \   / \      ^        ^       / \       / \        #
#  ┴   / \      ┴      ┴  ┴     ┴  _   / \      / \  ^    ┴    ^    ┴         #
#   ^   ┴      ^           ^     _/▓|.  ┴   ^    ┴  / \       / \       ^     #
#  / \    ^   / \    ^    / \   |▓▓▓| .    / \       ┴    ^    ┴       / \    #
#   ┴    / \   ┴ ^  / \    ┴    |▓▓▓▓| T    ┴ ^   ^      / \            ┴  ^  #
#         ┴   ^ / \  ┴   ^         ^      ^  / \ / \      ┴      ^    ^   / \ #
#    ^       / \ ┴      / \       / \    / \  ┴   ┴    ^        / \  / \   ┴  #
#   / \ ^     ┴          ┴         ┴      ┴           / \        ┴    ┴       #
#    ┴ / \              ▒░ ▒ ░           ░░ ▒▒▒ ▒ ░    ┴                   ░  #    
# X     ┴     ▒▒░  ▒░░ ▒        ▒░░░ ▒ ░ ^         ▒░     ▒ ▒░░  ▒▒  ▒  ░ ▒O▒▒#
# ▒  ▒▒ ░▒▒▒░           ^           ^   / \ ^   ^    ░ ▒░░ ^        ^        ▒#
#    ^          ^      / \  ^      / \ ^ ┴ / \ / \  ^     / \  ^   / \   ^    # 
#   / \  ^     / \      ┴  / \    ^ ┴ / \   ┴   ┴  / \     ┴  / \   ┴ _ / \   #
#    ┴  / \ ^   ┴   ^       ┴    / \   ┴     ^   ^  ┴     ^    ┴     /▓\ ┴    #
#        ┴ / \ ^   / \      ^     ┴     ^   / \ / \      / \        /▓▓▓\__   #
#  ^    ^   ┴ / \   ┴   ^  / \         / \   ┴   ┴   ^    ┴    ^   /▓▓▓▓▓▓▓\  #
# / \  / \ ^   ┴       / \  ┴  ^        ┴^   ^      / \   ^   / \ /▓▓▓▓▓▓▓▓▓\ #
#  ┴^   ┴ / \   ^   ^   ┴     / \   ^   / \ / \  ^   ┴   / \   ┴    ^         #
#  / \     ┴   / \ / \         ┴   / \   ┴   ┴  / \       ┴        / \        #
#   ┴           ┴   ┴               ┴            ┴                  ┴         #
###############################################################################

Chunk 3

###############################################################################
#      / \  ^    ^    ^                                                       #
#    ^  ┴  / \^ / \  / \______________________________________________________#
#   / \     ┴/ \ ┴ ^  ┴|  |▀▀▄███                  |■■■■■■  ×                |#
#  ^ ┴    ^   ┴   / \  |  |             ▓·    ×    |           ×   ░   ¬     |#
# / \ ^  / \   ^   ┴   |  |  _            o        |        o  ░             |#
#  ┴ / \  ┴   / \      |  |   |▓▓¡-  ▓|  ▓▓        | >▓o    ▓       ×  ·     |#
# ^   ┴  ^     ┴       |  |   |  |        ^        |        ^                |#
#/ \    / \            |  |             ░ ×        |    ░       ░×   ‗       |#
# ┴      ┴        _____|  |___________  ___________|_____________  __________|#
#                                    |  |          #            |  |      #####
#  X                                               #             B #      # O #
#      ^          _____   ___________|  |__________#____________|  |______#####
#     / \  ^           |  |                 ■      |                         |#
#  ^   ┴  / \          |  |      ■       ■             ▒▒▒▒▒▒▒▒▒▒▒▒▒▒▒▒▒▒▒▒▒ |#
# / \   ^  ┴   ^       |  | ■           ■     ■        ▒▒▒▒▒▒▒▒▒▒▒▒▒▒▒▒▒▒▒▒▒ |#
#  ┴   / \ ^  / \      |  |     ■                  ¬   ▒▒▒▒▒▒▒▒▒▒▒▒▒▒▒▒▒▒▒▒▒ |#
#  ^    ┴ / \  ┴ ^     |  |  ■             ■           ▒▒▒▒▒▒▒▒▒▒▒▒▒▒▒▒▒▒▒▒▒ |#
# / \ ^    ┴ ^  / \  ^ |  |      ■                 | ■ ▒▒▒▒▒▒▒▒▒▒▒▒▒▒▒▒▒▒▒▒▒ |#
#  ┴ / \  ^ / \  ┴^ / \|  |            ■           |■  ▒▒▒▒▒▒▒▒▒▒▒▒▒▒▒▒▒▒▒▒▒ |#
#     ┴  / \ ┴   / \ ┴ |__|________________________|_________________________|#
#         ┴       ┴                                                           #
###############################################################################

B for Boss

Chunk 4 after boss fight

###############################################################################
#      / \  ^    ^    ^                                                       #
#    ^  ┴  / \^ / \  / \______________________________________________________#
#   / \     ┴/ \ ┴ ^  ┴|  |▀▀▄███                  |■■■■■■  ×                |#
#  ^ ┴    ^   ┴   / \  |  |             ▓·    ×    |           ×   ░   ¬     |#
# / \ ^  / \   ^   ┴   |  |  _            o        |        o  ░             |#
#  ┴ / \  ┴   / \      |  |   |▓▓¡-  ▓|  ▓▓        | >▓o    ▓       ×  ·     |#
# ^   ┴  ^     ┴       |  |   |  |        ^        |        ^                |#
#/ \    / \            |  |             ░ ×        |    ░       ░×   ‗       |#
# ┴      ┴        _____|  |___________  ___________|_____________  __________|#
#                                    |  |          #            |  |      #####
#  X                                               #             ▓        # O #
#      ^          _____   ___________|  |__________#____________|  |______#####
#     / \  ^           |  |                 ■      |                         |#
#  ^   ┴  / \          |  |      ■       ■             ▒▒▒▒▒▒▒▒▒▒▒▒▒▒▒▒▒▒▒▒▒ |#
# / \   ^  ┴   ^       |  | ■           ■     ■        ▒▒▒▒▒▒▒▒▒▒▒▒▒▒▒▒▒▒▒▒▒ |#
#  ┴   / \ ^  / \      |  |     ■                  ¬   ▒▒▒▒▒▒▒▒▒▒▒▒▒▒▒▒▒▒▒▒▒ |#
#  ^    ┴ / \  ┴ ^     |  |  ■             ■           ▒▒▒▒▒▒▒▒▒▒▒▒▒▒▒▒▒▒▒▒▒ |#
# / \ ^    ┴ ^  / \  ^ |  |      ■                 | ■ ▒▒▒▒▒▒▒▒▒▒▒▒▒▒▒▒▒▒▒▒▒ |#
#  ┴ / \  ^ / \  ┴^ / \|  |            ■           |■  ▒▒▒▒▒▒▒▒▒▒▒▒▒▒▒▒▒▒▒▒▒ |#
#     ┴  / \ ┴   / \ ┴ |__|________________________|_________________________|#
#         ┴       ┴                                                           #
###############################################################################