
           █████ 
        ▄▄▄█████▄▄▄
          |     |
   │ │ │  |     |     
   │ │ │   ░░░░░      
   └─┼─┘    ░░░       
     │       |        
     ├-------|-------+ 
     │       |        
     │       |        
     │       |        
     │       |        
     │       |        
     │      / \       
     │     /   \      
     │    /     \     
     │   /       \    
     │  /         \   

Old farmer, talked to in "Baptism By Fire"