
         ____
        /    \
      __│    │__    
     (__|____|__)
     │          │
     │          │
     │          │
     │          │
     |__________|
     